REB = "countries/rebels.txt"
PIR = "countries/pirates.txt"
BAR = "countries/barbarians.txt"
MER = "countries/mercenaries.txt"

# West Europe

FRA = "countries/w_europe/france.txt"
GBR = "countries/w_europe/great_britain.txt"
SPA = "countries/w_europe/spain.txt"

# Central Europe

AUS = "countries/c_europe/austria.txt"
ANH = "countries/c_europe/anhalt.txt"
BAD = "countries/c_europe/baden.txt"
BAV = "countries/c_europe/bavaria.txt"
BRG = "countries/c_europe/braunschweig.txt"
BRE = "countries/c_europe/bremen.txt"
HAM = "countries/c_europe/hamburg.txt"
HAN = "countries/c_europe/hannover.txt"
HSD = "countries/c_europe/hesse-darmstadt.txt"
HSK = "countries/c_europe/hesse-kassel.txt"
MKS = "countries/c_europe/mecklenburg-schwerin.txt"
MKZ = "countries/c_europe/mecklenburg-strelitz.txt"
NAS = "countries/c_europe/nassau.txt"
OLD = "countries/c_europe/oldenburg.txt"
PRU = "countries/c_europe/prussia.txt"
SXC = "countries/c_europe/saxe-coburg.txt"
SXM = "countries/c_europe/saxe-meinegen.txt"
SAX = "countries/c_europe/saxony.txt"
WDK = "countries/c_europe/waldeck.txt"
WUR = "countries/c_europe/wurttemberg.txt"
FRK = "countries/c_europe/frankfurt.txt"
SWM = "countries/c_europe/saxe-weimar.txt"

# East Europe

RUS = "countries/e_europe/russia.txt"

# North America

USA = "countries/n_america/usa.txt"
MEX = "countries/n_america/mexico.txt"

# East Asia

CHI = "countries/e_asia/china.txt"

# Middle East

TUR = "countries/m_east/turkey.txt"